
25
25
#########################
#         *        #   *#
#  #            #*#  ####
#  *   #  #     *#  #   #
#  #   *        #  #  * #
#              #  #     #
#  *   #      #  #      #
#            #  #  ######
############ #          #
#   @      # #########  #
#*######## #            #
#        # #            #
######## # #    ####    #
#        # #   #    #   #
######## # #  # *##* #  #
#        # #  #   #  #  #
# ######## #   # *#*    #
#          #    #   #   #
########## #     ###    #
#          #      #     #
#*##########      #######
# #*#  *#       * #  *  #
# #        *#     #  ** #
#   #   *#    #*  #     #
#########################
